0100010000
0100010100
0100111000
0110010010
0000010000
0001010010
0100010100
0111110000
0111000000
0000000000